{
    "matriz": { "filas": 30, "columnas": 30 },
    "origen": [0, 0],
    "destino": [29, 29],
    "agujerosNegros": [
      [0, 1], [0, 2], [0, 3], [0, 4],
      [1, 3], [2, 3], [3, 3], [4, 3], [5, 3], [6, 3],
      [2, 0], [3, 1],
      [4, 5], [4, 6], [4, 7], [4, 8], [4, 9],
      [5, 8], [6, 8], [7, 8], [8, 8], [9, 8],
      [7, 0], [8, 1], [9, 2],
      [10, 1], [10, 2], [10, 3], [10, 4], [10, 5],
      [11, 4], [12, 4], [13, 4], [14, 4], [15, 4],
      [12, 0], [13, 1], [14, 2],
      [16, 5], [16, 6], [16, 7], [16, 8], [16, 9],
      [17, 8], [18, 8], [19, 8], [20, 8], [21, 8],
      [19, 0], [20, 1], [21, 2],
      [22, 3], [22, 4], [22, 5], [22, 6], [22, 7],
      [23, 6], [24, 6], [25, 6], [26, 6], [27, 6],
      [25, 0], [26, 1], [27, 2],
      [28, 3], [28, 4], [28, 5],
      [29, 4], [29, 5],
  
      [1, 10], [1, 11], [1, 12], [1, 13], [1, 14],
      [3, 15], [3, 16], [3, 17], [3, 18], [3, 19],
      [5, 20], [5, 21], [5, 22], [5, 23], [5, 24],
      [7, 25], [7, 26], [7, 27], [7, 28], [7, 29],
      [9, 10], [10, 10], [11, 10], [12, 10], [13, 10],
      [15, 10], [16, 10], [17, 10], [18, 10], [19, 10],
      [21, 10], [22, 10], [23, 10], [24, 10], [25, 10],
      [27, 10], [28, 10], [29, 10],
  
      [10, 18], [11, 18], [12, 18], [13, 18], [14, 18],
      [15, 20], [16, 20], [17, 20], [18, 20], [19, 20],
      [20, 22], [21, 22], [22, 22], [23, 22], [24, 22],
      [25, 24], [26, 24], [27, 24], [28, 24], [29, 24]
    ],
    "estrellasGigantes": [
      [0, 5], [2, 2], [4, 4], [6, 7], [8, 9], [10, 0],
      [12, 3], [14, 5], [16, 4], [18, 7], [20, 9], [22, 2],
      [24, 5], [26, 7], [28, 6],
      [2, 14], [4, 19], [6, 24], [8, 29],
      [14, 10], [20, 10], [26, 10],
      [12, 19], [18, 21], [24, 23], [29, 25]
    ],
    "portales": [
      { "desde": [0, 29], "hasta": [29, 15] },
      { "desde": [15, 0], "hasta": [0, 15] },
      { "desde": [29, 0], "hasta": [0, 28] }
    ],
    "agujerosGusano": [
      { "entrada": [2, 11], "salida": [11, 29] },
      { "entrada": [12, 12], "salida": [28, 28] },
      { "entrada": [20, 29], "salida": [29, 20] }
    ],
    "zonasRecarga": [
      [1, 29, 3],
      [11, 28, 2],
      [21, 29, 4],
      [28, 29, 3],
      [1, 15, 2],
      [15, 1, 3]
    ],
    "celdasCargaRequerida": [
      { "coordenada": [2, 15], "cargaGastada": 100 },
      { "coordenada": [13, 29], "cargaGastada": 150 },
      { "coordenada": [25, 27], "cargaGastada": 200 },
      { "coordenada": [14, 14], "cargaGastada": 120 }
    ],
    "cargaInicial": 1500,
    "matrizInicial": [
      [5, 3, 2, 8, 1, 9, 4, 7, 6, 2, 5, 3, 2, 8, 1, 9, 4, 7, 6, 2, 5, 3, 2, 8, 1, 9, 4, 7, 6, 2],
      [2, 7, 5, 1, 6, 3, 8, 2, 9, 4, 2, 7, 5, 1, 6, 3, 8, 2, 9, 4, 2, 7, 5, 1, 6, 3, 8, 2, 9, 4],
      [8, 1, 6, 4, 9, 2, 7, 5, 3, 1, 8, 1, 6, 4, 9, 2, 7, 5, 3, 1, 8, 1, 6, 4, 9, 2, 7, 5, 3, 1],
      [3, 9, 2, 5, 8, 1, 6, 4, 7, 2, 3, 9, 2, 5, 8, 1, 6, 4, 7, 2, 3, 9, 2, 5, 8, 1, 6, 4, 7, 2],
      [7, 5, 3, 1, 4, 9, 2, 8, 6, 3, 7, 5, 3, 1, 4, 9, 2, 8, 6, 3, 7, 5, 3, 1, 4, 9, 2, 8, 6, 3],
      [1, 2, 8, 6, 3, 7, 5, 9, 4, 1, 1, 2, 8, 6, 3, 7, 5, 9, 4, 1, 1, 2, 8, 6, 3, 7, 5, 9, 4, 1],
      [9, 4, 7, 2, 5, 8, 1, 6, 3, 5, 9, 4, 7, 2, 5, 8, 1, 6, 3, 5, 9, 4, 7, 2, 5, 8, 1, 6, 3, 5],
      [6, 3, 1, 9, 4, 7, 2, 5, 8, 6, 6, 3, 1, 9, 4, 7, 2, 5, 8, 6, 6, 3, 1, 9, 4, 7, 2, 5, 8, 6],
      [4, 8, 2, 7, 5, 3, 9, 1, 6, 7, 4, 8, 2, 7, 5, 3, 9, 1, 6, 7, 4, 8, 2, 7, 5, 3, 9, 1, 6, 7],
      [2, 6, 9, 3, 8, 4, 1, 7, 5, 9, 2, 6, 9, 3, 8, 4, 1, 7, 5, 9, 2, 6, 9, 3, 8, 4, 1, 7, 5, 9],
      [5, 3, 2, 8, 1, 9, 4, 7, 6, 2, 5, 3, 2, 8, 1, 9, 4, 7, 6, 2, 5, 3, 2, 8, 1, 9, 4, 7, 6, 2],
      [2, 7, 5, 1, 6, 3, 8, 2, 9, 4, 2, 7, 5, 1, 6, 3, 8, 2, 9, 4, 2, 7, 5, 1, 6, 3, 8, 2, 9, 4],
      [8, 1, 6, 4, 9, 2, 7, 5, 3, 1, 8, 1, 6, 4, 9, 2, 7, 5, 3, 1, 8, 1, 6, 4, 9, 2, 7, 5, 3, 1],
      [3, 9, 2, 5, 8, 1, 6, 4, 7, 2, 3, 9, 2, 5, 8, 1, 6, 4, 7, 2, 3, 9, 2, 5, 8, 1, 6, 4, 7, 2],
      [7, 5, 3, 1, 4, 9, 2, 8, 6, 3, 7, 5, 3, 1, 4, 9, 2, 8, 6, 3, 7, 5, 3, 1, 4, 9, 2, 8, 6, 3],
      [1, 2, 8, 6, 3, 7, 5, 9, 4, 1, 1, 2, 8, 6, 3, 7, 5, 9, 4, 1, 1, 2, 8, 6, 3, 7, 5, 9, 4, 1],
      [9, 4, 7, 2, 5, 8, 1, 6, 3, 5, 9, 4, 7, 2, 5, 8, 1, 6, 3, 5, 9, 4, 7, 2, 5, 8, 1, 6, 3, 5],
      [6, 3, 1, 9, 4, 7, 2, 5, 8, 6, 6, 3, 1, 9, 4, 7, 2, 5, 8, 6, 6, 3, 1, 9, 4, 7, 2, 5, 8, 6],
      [4, 8, 2, 7, 5, 3, 9, 1, 6, 7, 4, 8, 2, 7, 5, 3, 9, 1, 6, 7, 4, 8, 2, 7, 5, 3, 9, 1, 6, 7],
      [2, 6, 9, 3, 8, 4, 1, 7, 5, 9, 2, 6, 9, 3, 8, 4, 1, 7, 5, 9, 2, 6, 9, 3, 8, 4, 1, 7, 5, 9],
      [5, 3, 2, 8, 1, 9, 4, 7, 6, 2, 5, 3, 2, 8, 1, 9, 4, 7, 6, 2, 5, 3, 2, 8, 1, 9, 4, 7, 6, 2],
      [2, 7, 5, 1, 6, 3, 8, 2, 9, 4, 2, 7, 5, 1, 6, 3, 8, 2, 9, 4, 2, 7, 5, 1, 6, 3, 8, 2, 9, 4],
      [8, 1, 6, 4, 9, 2, 7, 5, 3, 1, 8, 1, 6, 4, 9, 2, 7, 5, 3, 1, 8, 1, 6, 4, 9, 2, 7, 5, 3, 1],
      [3, 9, 2, 5, 8, 1, 6, 4, 7, 2, 3, 9, 2, 5, 8, 1, 6, 4, 7, 2, 3, 9, 2, 5, 8, 1, 6, 4, 7, 2],
      [7, 5, 3, 1, 4, 9, 2, 8, 6, 3, 7, 5, 3, 1, 4, 9, 2, 8, 6, 3, 7, 5, 3, 1, 4, 9, 2, 8, 6, 3],
      [1, 2, 8, 6, 3, 7, 5, 9, 4, 1, 1, 2, 8, 6, 3, 7, 5, 9, 4, 1, 1, 2, 8, 6, 3, 7, 5, 9, 4, 1],
      [9, 4, 7, 2, 5, 8, 1, 6, 3, 5, 9, 4, 7, 2, 5, 8, 1, 6, 3, 5, 9, 4, 7, 2, 5, 8, 1, 6, 3, 5],
      [6, 3, 1, 9, 4, 7, 2, 5, 8, 6, 6, 3, 1, 9, 4, 7, 2, 5, 8, 6, 6, 3, 1, 9, 4, 7, 2, 5, 8, 6],
      [4, 8, 2, 7, 5, 3, 9, 1, 6, 7, 4, 8, 2, 7, 5, 3, 9, 1, 6, 7, 4, 8, 2, 7, 5, 3, 9, 1, 6, 7],
      [2, 6, 9, 3, 8, 4, 1, 7, 5, 9, 2, 6, 9, 3, 8, 4, 1, 7, 5, 9, 2, 6, 9, 3, 8, 4, 1, 7, 5, 9]
    ]
  }