{
  "matriz": { "filas": 30, "columnas": 30 },
  "origen": [0, 0],
  "destino": [29, 29],
  "agujerosNegros": [
    [1, 1], [1, 2], [1, 3], [1, 4], [1, 5],
    [3, 3], [4, 3], [5, 3], [6, 3], [7, 3],
    [8, 8], [8, 9], [8, 10], [8, 11], [8, 12],
    [10, 10], [11, 10], [12, 10], [13, 10], [14, 10],
    [15, 15], [15, 16], [15, 17], [15, 18], [15, 19],
    [17, 17], [18, 17], [19, 17], [20, 17], [21, 17],
    [22, 22], [22, 23], [22, 24], [22, 25], [22, 26],
    [24, 24], [25, 24], [26, 24], [27, 24], [28, 24],
    [29, 28], [28, 29], [27, 29], [26, 29], [25, 29],
    [0, 20], [1, 20], [2, 20], [3, 20], [4, 20],
    [20, 0], [20, 1], [20, 2], [20, 3], [20, 4]
  ],
  "estrellasGigantes": [
    [0, 1], [2, 3], [7, 8], [9, 10], [14, 15],
    [16, 17], [21, 22], [23, 24], [29, 27], [5, 20],
    [21, 0]
  ],
  "portales": [
    { "desde": [0, 29], "hasta": [29, 0] },
    { "desde": [5, 10], "hasta": [25, 10] },
    { "desde": [10, 25], "hasta": [20, 5] }
  ],
  "agujerosGusano": [
    { "entrada": [2, 2], "salida": [28, 28] },
    { "entrada": [6, 1], "salida": [18, 1] },
    { "entrada": [13, 29], "salida": [29, 13] }
  ],
  "zonasRecarga": [
    [2, 0, 3],
    [7, 2, 2],
    [14, 12, 4],
    [21, 19, 3],
    [26, 26, 2]
  ],
  "celdasCargaRequerida": [
    { "coordenada": [4, 1], "cargaGastada": 100 },
    { "coordenada": [9, 14], "cargaGastada": 150 },
    { "coordenada": [16, 20], "cargaGastada": 120 },
    { "coordenada": [23, 15], "cargaGastada": 180 },
    { "coordenada": [28, 20], "cargaGastada": 200 }
  ],
  "cargaInicial": 1000,
  "matrizInicial": [
    [5, 3, 2, 8, 1, 9, 4, 7, 6, 2, 5, 3, 2, 8, 1, 9, 4, 7, 6, 2, 5, 3, 2, 8, 1, 9, 4, 7, 6, 2],
    [2, 7, 5, 1, 6, 3, 8, 2, 9, 4, 2, 7, 5, 1, 6, 3, 8, 2, 9, 4, 2, 7, 5, 1, 6, 3, 8, 2, 9, 4],
    [8, 1, 6, 4, 9, 2, 7, 5, 3, 1, 8, 1, 6, 4, 9, 2, 7, 5, 3, 1, 8, 1, 6, 4, 9, 2, 7, 5, 3, 1],
    [3, 9, 2, 5, 8, 1, 6, 4, 7, 2, 3, 9, 2, 5, 8, 1, 6, 4, 7, 2, 3, 9, 2, 5, 8, 1, 6, 4, 7, 2],
    [7, 5, 3, 1, 4, 9, 2, 8, 6, 3, 7, 5, 3, 1, 4, 9, 2, 8, 6, 3, 7, 5, 3, 1, 4, 9, 2, 8, 6, 3],
    [1, 2, 8, 6, 3, 7, 5, 9, 4, 1, 1, 2, 8, 6, 3, 7, 5, 9, 4, 1, 1, 2, 8, 6, 3, 7, 5, 9, 4, 1],
    [9, 4, 7, 2, 5, 8, 1, 6, 3, 5, 9, 4, 7, 2, 5, 8, 1, 6, 3, 5, 9, 4, 7, 2, 5, 8, 1, 6, 3, 5],
    [6, 3, 1, 9, 4, 7, 2, 5, 8, 6, 6, 3, 1, 9, 4, 7, 2, 5, 8, 6, 6, 3, 1, 9, 4, 7, 2, 5, 8, 6],
    [4, 8, 2, 7, 5, 3, 9, 1, 6, 7, 4, 8, 2, 7, 5, 3, 9, 1, 6, 7, 4, 8, 2, 7, 5, 3, 9, 1, 6, 7],
    [2, 6, 9, 3, 8, 4, 1, 7, 5, 9, 2, 6, 9, 3, 8, 4, 1, 7, 5, 9, 2, 6, 9, 3, 8, 4, 1, 7, 5, 9],
    [5, 3, 2, 8, 1, 9, 4, 7, 6, 2, 5, 3, 2, 8, 1, 9, 4, 7, 6, 2, 5, 3, 2, 8, 1, 9, 4, 7, 6, 2],
    [2, 7, 5, 1, 6, 3, 8, 2, 9, 4, 2, 7, 5, 1, 6, 3, 8, 2, 9, 4, 2, 7, 5, 1, 6, 3, 8, 2, 9, 4],
    [8, 1, 6, 4, 9, 2, 7, 5, 3, 1, 8, 1, 6, 4, 9, 2, 7, 5, 3, 1, 8, 1, 6, 4, 9, 2, 7, 5, 3, 1],
    [3, 9, 2, 5, 8, 1, 6, 4, 7, 2, 3, 9, 2, 5, 8, 1, 6, 4, 7, 2, 3, 9, 2, 5, 8, 1, 6, 4, 7, 2],
    [7, 5, 3, 1, 4, 9, 2, 8, 6, 3, 7, 5, 3, 1, 4, 9, 2, 8, 6, 3, 7, 5, 3, 1, 4, 9, 2, 8, 6, 3],
    [1, 2, 8, 6, 3, 7, 5, 9, 4, 1, 1, 2, 8, 6, 3, 7, 5, 9, 4, 1, 1, 2, 8, 6, 3, 7, 5, 9, 4, 1],
    [9, 4, 7, 2, 5, 8, 1, 6, 3, 5, 9, 4, 7, 2, 5, 8, 1, 6, 3, 5, 9, 4, 7, 2, 5, 8, 1, 6, 3, 5],
    [6, 3, 1, 9, 4, 7, 2, 5, 8, 6, 6, 3, 1, 9, 4, 7, 2, 5, 8, 6, 6, 3, 1, 9, 4, 7, 2, 5, 8, 6],
    [4, 8, 2, 7, 5, 3, 9, 1, 6, 7, 4, 8, 2, 7, 5, 3, 9, 1, 6, 7, 4, 8, 2, 7, 5, 3, 9, 1, 6, 7],
    [2, 6, 9, 3, 8, 4, 1, 7, 5, 9, 2, 6, 9, 3, 8, 4, 1, 7, 5, 9, 2, 6, 9, 3, 8, 4, 1, 7, 5, 9],
    [5, 3, 2, 8, 1, 9, 4, 7, 6, 2, 5, 3, 2, 8, 1, 9, 4, 7, 6, 2, 5, 3, 2, 8, 1, 9, 4, 7, 6, 2],
    [2, 7, 5, 1, 6, 3, 8, 2, 9, 4, 2, 7, 5, 1, 6, 3, 8, 2, 9, 4, 2, 7, 5, 1, 6, 3, 8, 2, 9, 4],
    [8, 1, 6, 4, 9, 2, 7, 5, 3, 1, 8, 1, 6, 4, 9, 2, 7, 5, 3, 1, 8, 1, 6, 4, 9, 2, 7, 5, 3, 1],
    [3, 9, 2, 5, 8, 1, 6, 4, 7, 2, 3, 9, 2, 5, 8, 1, 6, 4, 7, 2, 3, 9, 2, 5, 8, 1, 6, 4, 7, 2],
    [7, 5, 3, 1, 4, 9, 2, 8, 6, 3, 7, 5, 3, 1, 4, 9, 2, 8, 6, 3, 7, 5, 3, 1, 4, 9, 2, 8, 6, 3],
    [1, 2, 8, 6, 3, 7, 5, 9, 4, 1, 1, 2, 8, 6, 3, 7, 5, 9, 4, 1, 1, 2, 8, 6, 3, 7, 5, 9, 4, 1],
    [9, 4, 7, 2, 5, 8, 1, 6, 3, 5, 9, 4, 7, 2, 5, 8, 1, 6, 3, 5, 9, 4, 7, 2, 5, 8, 1, 6, 3, 5],
    [6, 3, 1, 9, 4, 7, 2, 5, 8, 6, 6, 3, 1, 9, 4, 7, 2, 5, 8, 6, 6, 3, 1, 9, 4, 7, 2, 5, 8, 6],
    [4, 8, 2, 7, 5, 3, 9, 1, 6, 7, 4, 8, 2, 7, 5, 3, 9, 1, 6, 7, 4, 8, 2, 7, 5, 3, 9, 1, 6, 7],
    [2, 6, 9, 3, 8, 4, 1, 7, 5, 9, 2, 6, 9, 3, 8, 4, 1, 7, 5, 9, 2, 6, 9, 3, 8, 4, 1, 7, 5, 9]
  ]
}