{
    "matriz": { "filas": 30, "columnas": 30 },
    "origen": [0, 0],
    "destino": [29, 29],
    "agujerosNegros": [
      [1, 1],
      [5, 5],
      [10, 10],
      [15, 15],
      [20, 20],
      [25, 25],
      [0, 5],
      [5, 0],
      [29, 24],
      [24, 29]
    ],
    "estrellasGigantes": [
      [0, 1],
      [4, 5],
      [9, 10],
      [14, 15],
      [19, 20],
      [24, 25]
    ],
    "portales": [
      { "desde": [2, 2], "hasta": [27, 27] },
      { "desde": [10, 5], "hasta": [15, 25] },
      { "desde": [5, 28], "hasta": [28, 5] }
    ],
    "agujerosGusano": [
      { "entrada": [3, 3], "salida": [25, 5] },
      { "entrada": [7, 7], "salida": [20, 10] },
      { "entrada": [12, 2], "salida": [2, 12] }
    ],
    "zonasRecarga": [
      [2, 1, 3],
      [8, 8, 2],
      [13, 13, 3],
      [18, 18, 2],
      [23, 23, 4],
      [27, 27, 2]
    ],
    "celdasCargaRequerida": [
      { "coordenada": [4, 4], "cargaGastada": 100 },
      { "coordenada": [9, 9], "cargaGastada": 120 },
      { "coordenada": [14, 14], "cargaGastada": 150 },
      { "coordenada": [19, 19], "cargaGastada": 130 },
      { "coordenada": [24, 24], "cargaGastada": 160 }
    ],
    "cargaInicial": 800,
    "matrizInicial": [
      [5, 3, 2, 8, 1, 9, 4, 7, 6, 2, 5, 3, 2, 8, 1, 9, 4, 7, 6, 2, 5, 3, 2, 8, 1, 9, 4, 7, 6, 2],
      [2, 7, 5, 1, 6, 3, 8, 2, 9, 4, 2, 7, 5, 1, 6, 3, 8, 2, 9, 4, 2, 7, 5, 1, 6, 3, 8, 2, 9, 4],
      [8, 1, 6, 4, 9, 2, 7, 5, 3, 1, 8, 1, 6, 4, 9, 2, 7, 5, 3, 1, 8, 1, 6, 4, 9, 2, 7, 5, 3, 1],
      [3, 9, 2, 5, 8, 1, 6, 4, 7, 2, 3, 9, 2, 5, 8, 1, 6, 4, 7, 2, 3, 9, 2, 5, 8, 1, 6, 4, 7, 2],
      [7, 5, 3, 1, 4, 9, 2, 8, 6, 3, 7, 5, 3, 1, 4, 9, 2, 8, 6, 3, 7, 5, 3, 1, 4, 9, 2, 8, 6, 3],
      [1, 2, 8, 6, 3, 7, 5, 9, 4, 1, 1, 2, 8, 6, 3, 7, 5, 9, 4, 1, 1, 2, 8, 6, 3, 7, 5, 9, 4, 1],
      [9, 4, 7, 2, 5, 8, 1, 6, 3, 5, 9, 4, 7, 2, 5, 8, 1, 6, 3, 5, 9, 4, 7, 2, 5, 8, 1, 6, 3, 5],
      [6, 3, 1, 9, 4, 7, 2, 5, 8, 6, 6, 3, 1, 9, 4, 7, 2, 5, 8, 6, 6, 3, 1, 9, 4, 7, 2, 5, 8, 6],
      [4, 8, 2, 7, 5, 3, 9, 1, 6, 7, 4, 8, 2, 7, 5, 3, 9, 1, 6, 7, 4, 8, 2, 7, 5, 3, 9, 1, 6, 7],
      [2, 6, 9, 3, 8, 4, 1, 7, 5, 9, 2, 6, 9, 3, 8, 4, 1, 7, 5, 9, 2, 6, 9, 3, 8, 4, 1, 7, 5, 9],
      [5, 3, 2, 8, 1, 9, 4, 7, 6, 2, 5, 3, 2, 8, 1, 9, 4, 7, 6, 2, 5, 3, 2, 8, 1, 9, 4, 7, 6, 2],
      [2, 7, 5, 1, 6, 3, 8, 2, 9, 4, 2, 7, 5, 1, 6, 3, 8, 2, 9, 4, 2, 7, 5, 1, 6, 3, 8, 2, 9, 4],
      [8, 1, 6, 4, 9, 2, 7, 5, 3, 1, 8, 1, 6, 4, 9, 2, 7, 5, 3, 1, 8, 1, 6, 4, 9, 2, 7, 5, 3, 1],
      [3, 9, 2, 5, 8, 1, 6, 4, 7, 2, 3, 9, 2, 5, 8, 1, 6, 4, 7, 2, 3, 9, 2, 5, 8, 1, 6, 4, 7, 2],
      [7, 5, 3, 1, 4, 9, 2, 8, 6, 3, 7, 5, 3, 1, 4, 9, 2, 8, 6, 3, 7, 5, 3, 1, 4, 9, 2, 8, 6, 3],
      [1, 2, 8, 6, 3, 7, 5, 9, 4, 1, 1, 2, 8, 6, 3, 7, 5, 9, 4, 1, 1, 2, 8, 6, 3, 7, 5, 9, 4, 1],
      [9, 4, 7, 2, 5, 8, 1, 6, 3, 5, 9, 4, 7, 2, 5, 8, 1, 6, 3, 5, 9, 4, 7, 2, 5, 8, 1, 6, 3, 5],
      [6, 3, 1, 9, 4, 7, 2, 5, 8, 6, 6, 3, 1, 9, 4, 7, 2, 5, 8, 6, 6, 3, 1, 9, 4, 7, 2, 5, 8, 6],
      [4, 8, 2, 7, 5, 3, 9, 1, 6, 7, 4, 8, 2, 7, 5, 3, 9, 1, 6, 7, 4, 8, 2, 7, 5, 3, 9, 1, 6, 7],
      [2, 6, 9, 3, 8, 4, 1, 7, 5, 9, 2, 6, 9, 3, 8, 4, 1, 7, 5, 9, 2, 6, 9, 3, 8, 4, 1, 7, 5, 9],
      [5, 3, 2, 8, 1, 9, 4, 7, 6, 2, 5, 3, 2, 8, 1, 9, 4, 7, 6, 2, 5, 3, 2, 8, 1, 9, 4, 7, 6, 2],
      [2, 7, 5, 1, 6, 3, 8, 2, 9, 4, 2, 7, 5, 1, 6, 3, 8, 2, 9, 4, 2, 7, 5, 1, 6, 3, 8, 2, 9, 4],
      [8, 1, 6, 4, 9, 2, 7, 5, 3, 1, 8, 1, 6, 4, 9, 2, 7, 5, 3, 1, 8, 1, 6, 4, 9, 2, 7, 5, 3, 1],
      [3, 9, 2, 5, 8, 1, 6, 4, 7, 2, 3, 9, 2, 5, 8, 1, 6, 4, 7, 2, 3, 9, 2, 5, 8, 1, 6, 4, 7, 2],
      [7, 5, 3, 1, 4, 9, 2, 8, 6, 3, 7, 5, 3, 1, 4, 9, 2, 8, 6, 3, 7, 5, 3, 1, 4, 9, 2, 8, 6, 3],
      [1, 2, 8, 6, 3, 7, 5, 9, 4, 1, 1, 2, 8, 6, 3, 7, 5, 9, 4, 1, 1, 2, 8, 6, 3, 7, 5, 9, 4, 1],
      [9, 4, 7, 2, 5, 8, 1, 6, 3, 5, 9, 4, 7, 2, 5, 8, 1, 6, 3, 5, 9, 4, 7, 2, 5, 8, 1, 6, 3, 5],
      [6, 3, 1, 9, 4, 7, 2, 5, 8, 6, 6, 3, 1, 9, 4, 7, 2, 5, 8, 6, 6, 3, 1, 9, 4, 7, 2, 5, 8, 6],
      [4, 8, 2, 7, 5, 3, 9, 1, 6, 7, 4, 8, 2, 7, 5, 3, 9, 1, 6, 7, 4, 8, 2, 7, 5, 3, 9, 1, 6, 7],
      [2, 6, 9, 3, 8, 4, 1, 7, 5, 9, 2, 6, 9, 3, 8, 4, 1, 7, 5, 9, 2, 6, 9, 3, 8, 4, 1, 7, 5, 9]
    ]
  }