{
    "matriz": { "filas": 30, "columnas": 30 },
    "origen": [0, 0],
    "destino": [29, 29],
    "agujerosNegros": [
      [0, 1], [0, 2], [0, 3], [0, 4], [0, 5], [0, 6],
      [1, 6], [2, 6], [3, 6], [4, 6], [5, 6], [6, 6],
      [2, 0], [3, 1], [4, 2], [5, 3],
      [7, 0], [7, 1], [7, 2], [7, 3], [7, 4], [7, 5], [7, 6],
      [9, 5], [9, 6], [9, 7], [9, 8], [9, 9],
      [11, 0], [11, 1], [11, 2], [11, 3], [11, 4], [11, 5],
      [13, 5], [13, 6], [13, 7], [13, 8], [13, 9],
      [15, 0], [15, 1], [15, 2], [15, 3], [15, 4], [15, 5], [15, 6],
      [17, 6], [17, 7], [17, 8], [17, 9], [17, 10],
      [19, 0], [19, 1], [19, 2], [19, 3], [19, 4],
      [21, 4], [21, 5], [21, 6], [21, 7], [21, 8],
      [23, 0], [23, 1], [23, 2], [23, 3],
      [25, 3], [25, 4], [25, 5], [25, 6], [25, 7],
      [27, 0], [27, 1], [27, 2], [27, 3], [27, 4],
      [29, 1], [29, 2], [29, 3], [29, 4], [29, 5],
      [8, 20], [9, 20], [10, 20], [11, 20], [12, 20],
      [14, 25], [15, 25], [16, 25], [17, 25],
      [20, 20], [21, 20], [22, 20], [23, 20], [24, 20],
      [26, 20], [27, 20], [28, 20], [29, 20],
      [28, 28], [28, 27], [27, 28]
    ],
    "estrellasGigantes": [
      [1, 0], [6, 5], [8, 0], [10, 6], [12, 0], [14, 7], [16, 0], [18, 11],
      [20, 0], [22, 9], [24, 0], [26, 8], [28, 0], [28, 29]
    ],
    "portales": [
      { "desde": [0, 29], "hasta": [29, 15] },
      { "desde": [10, 29], "hasta": [29, 10] },
      { "desde": [20, 29], "hasta": [29, 5] }
    ],
    "agujerosGusano": [
      { "entrada": [5, 29], "salida": [25, 2] },
      { "entrada": [15, 29], "salida": [2, 25] },
      { "entrada": [25, 29], "salida": [10, 2] }
    ],
    "zonasRecarga": [
      [2, 29, 3],
      [12, 29, 2],
      [22, 29, 4],
      [29, 0, 3],
      [20, 10, 2],
      [10, 15, 3]
    ],
    "celdasCargaRequerida": [
      { "coordenada": [1, 28], "cargaGastada": 200 },
      { "coordenada": [12, 28], "cargaGastada": 250 },
      { "coordenada": [23, 28], "cargaGastada": 300 },
      { "coordenada": [28, 26], "cargaGastada": 350 },
      { "coordenada": [6, 20], "cargaGastada": 180 },
      { "coordenada": [18, 20], "cargaGastada": 220 }
    ],
    "cargaInicial": 1500,
    "matrizInicial": [
      [5, 3, 2, 8, 1, 9, 4, 7, 6, 2, 5, 3, 2, 8, 1, 9, 4, 7, 6, 2, 5, 3, 2, 8, 1, 9, 4, 7, 6, 2],
      [2, 7, 5, 1, 6, 3, 8, 2, 9, 4, 2, 7, 5, 1, 6, 3, 8, 2, 9, 4, 2, 7, 5, 1, 6, 3, 8, 2, 9, 4],
      [8, 1, 6, 4, 9, 2, 7, 5, 3, 1, 8, 1, 6, 4, 9, 2, 7, 5, 3, 1, 8, 1, 6, 4, 9, 2, 7, 5, 3, 1],
      [3, 9, 2, 5, 8, 1, 6, 4, 7, 2, 3, 9, 2, 5, 8, 1, 6, 4, 7, 2, 3, 9, 2, 5, 8, 1, 6, 4, 7, 2],
      [7, 5, 3, 1, 4, 9, 2, 8, 6, 3, 7, 5, 3, 1, 4, 9, 2, 8, 6, 3, 7, 5, 3, 1, 4, 9, 2, 8, 6, 3],
      [1, 2, 8, 6, 3, 7, 5, 9, 4, 1, 1, 2, 8, 6, 3, 7, 5, 9, 4, 1, 1, 2, 8, 6, 3, 7, 5, 9, 4, 1],
      [9, 4, 7, 2, 5, 8, 1, 6, 3, 5, 9, 4, 7, 2, 5, 8, 1, 6, 3, 5, 9, 4, 7, 2, 5, 8, 1, 6, 3, 5],
      [6, 3, 1, 9, 4, 7, 2, 5, 8, 6, 6, 3, 1, 9, 4, 7, 2, 5, 8, 6, 6, 3, 1, 9, 4, 7, 2, 5, 8, 6],
      [4, 8, 2, 7, 5, 3, 9, 1, 6, 7, 4, 8, 2, 7, 5, 3, 9, 1, 6, 7, 4, 8, 2, 7, 5, 3, 9, 1, 6, 7],
      [2, 6, 9, 3, 8, 4, 1, 7, 5, 9, 2, 6, 9, 3, 8, 4, 1, 7, 5, 9, 2, 6, 9, 3, 8, 4, 1, 7, 5, 9],
      [5, 3, 2, 8, 1, 9, 4, 7, 6, 2, 5, 3, 2, 8, 1, 9, 4, 7, 6, 2, 5, 3, 2, 8, 1, 9, 4, 7, 6, 2],
      [2, 7, 5, 1, 6, 3, 8, 2, 9, 4, 2, 7, 5, 1, 6, 3, 8, 2, 9, 4, 2, 7, 5, 1, 6, 3, 8, 2, 9, 4],
      [8, 1, 6, 4, 9, 2, 7, 5, 3, 1, 8, 1, 6, 4, 9, 2, 7, 5, 3, 1, 8, 1, 6, 4, 9, 2, 7, 5, 3, 1],
      [3, 9, 2, 5, 8, 1, 6, 4, 7, 2, 3, 9, 2, 5, 8, 1, 6, 4, 7, 2, 3, 9, 2, 5, 8, 1, 6, 4, 7, 2],
      [7, 5, 3, 1, 4, 9, 2, 8, 6, 3, 7, 5, 3, 1, 4, 9, 2, 8, 6, 3, 7, 5, 3, 1, 4, 9, 2, 8, 6, 3],
      [1, 2, 8, 6, 3, 7, 5, 9, 4, 1, 1, 2, 8, 6, 3, 7, 5, 9, 4, 1, 1, 2, 8, 6, 3, 7, 5, 9, 4, 1],
      [9, 4, 7, 2, 5, 8, 1, 6, 3, 5, 9, 4, 7, 2, 5, 8, 1, 6, 3, 5, 9, 4, 7, 2, 5, 8, 1, 6, 3, 5],
      [6, 3, 1, 9, 4, 7, 2, 5, 8, 6, 6, 3, 1, 9, 4, 7, 2, 5, 8, 6, 6, 3, 1, 9, 4, 7, 2, 5, 8, 6],
      [4, 8, 2, 7, 5, 3, 9, 1, 6, 7, 4, 8, 2, 7, 5, 3, 9, 1, 6, 7, 4, 8, 2, 7, 5, 3, 9, 1, 6, 7],
      [2, 6, 9, 3, 8, 4, 1, 7, 5, 9, 2, 6, 9, 3, 8, 4, 1, 7, 5, 9, 2, 6, 9, 3, 8, 4, 1, 7, 5, 9],
      [5, 3, 2, 8, 1, 9, 4, 7, 6, 2, 5, 3, 2, 8, 1, 9, 4, 7, 6, 2, 5, 3, 2, 8, 1, 9, 4, 7, 6, 2],
      [2, 7, 5, 1, 6, 3, 8, 2, 9, 4, 2, 7, 5, 1, 6, 3, 8, 2, 9, 4, 2, 7, 5, 1, 6, 3, 8, 2, 9, 4],
      [8, 1, 6, 4, 9, 2, 7, 5, 3, 1, 8, 1, 6, 4, 9, 2, 7, 5, 3, 1, 8, 1, 6, 4, 9, 2, 7, 5, 3, 1],
      [3, 9, 2, 5, 8, 1, 6, 4, 7, 2, 3, 9, 2, 5, 8, 1, 6, 4, 7, 2, 3, 9, 2, 5, 8, 1, 6, 4, 7, 2],
      [7, 5, 3, 1, 4, 9, 2, 8, 6, 3, 7, 5, 3, 1, 4, 9, 2, 8, 6, 3, 7, 5, 3, 1, 4, 9, 2, 8, 6, 3],
      [1, 2, 8, 6, 3, 7, 5, 9, 4, 1, 1, 2, 8, 6, 3, 7, 5, 9, 4, 1, 1, 2, 8, 6, 3, 7, 5, 9, 4, 1],
      [9, 4, 7, 2, 5, 8, 1, 6, 3, 5, 9, 4, 7, 2, 5, 8, 1, 6, 3, 5, 9, 4, 7, 2, 5, 8, 1, 6, 3, 5],
      [6, 3, 1, 9, 4, 7, 2, 5, 8, 6, 6, 3, 1, 9, 4, 7, 2, 5, 8, 6, 6, 3, 1, 9, 4, 7, 2, 5, 8, 6],
      [4, 8, 2, 7, 5, 3, 9, 1, 6, 7, 4, 8, 2, 7, 5, 3, 9, 1, 6, 7, 4, 8, 2, 7, 5, 3, 9, 1, 6, 7],
      [2, 6, 9, 3, 8, 4, 1, 7, 5, 9, 2, 6, 9, 3, 8, 4, 1, 7, 5, 9, 2, 6, 9, 3, 8, 4, 1, 7, 5, 9]
    ]
  }