{
  "matriz": { "filas": 30, "columnas": 30 },
  "origen": [0, 0],
  "destino": [29, 29],
  "agujerosNegros": [
    [10, 10], [10, 11], [11, 10], [11, 11],
    [20, 20], [20, 21], [21, 20], [21, 21]
  ],
  "estrellasGigantes": [
    [9, 10], [19, 20], [25, 25], [15, 15], [5, 5]
  ],
  "portales": [
    { "desde": [5, 5], "hasta": [25, 25] }
  ],
  "agujerosGusano": [
    { "entrada": [8, 8], "salida": [22, 22] }
  ],
  "zonasRecarga": [
    [3, 3, 2],
    [7, 7, 3],
    [12, 12, 2],
    [16, 16, 3],
    [21, 21, 2],
    [25, 25, 3],
    [28, 28, 4]
  ],
  "celdasCargaRequerida": [
    { "coordenada": [5, 5], "cargaGastada": 30 },
    { "coordenada": [10, 10], "cargaGastada": 50 },
    { "coordenada": [15, 15], "cargaGastada": 70 },
    { "coordenada": [20, 20], "cargaGastada": 90 },
    { "coordenada": [25, 25], "cargaGastada": 110 },
    { "coordenada": [28, 28], "cargaGastada": 130 }
  ],
  "cargaInicial": 100,
  "matrizInicial": [
    [5,6,7,5,6,7,5,6,7,5,6,7,5,6,7,5,6,7,5,6,7,5,6,7,5,6,7,5,6,7],
    [6,7,5,6,7,5,6,7,5,6,7,5,6,7,5,6,7,5,6,7,5,6,7,5,6,7,5,6,7,5],
    [7,5,6,7,5,6,7,5,6,7,5,6,7,5,6,7,5,6,7,5,6,7,5,6,7,5,6,7,5,6],
    [5,6,7,5,6,7,5,6,7,5,6,7,5,6,7,5,6,7,5,6,7,5,6,7,5,6,7,5,6,7],
    [6,7,5,6,7,5,6,7,5,6,7,5,6,7,5,6,7,5,6,7,5,6,7,5,6,7,5,6,7,5],
    [7,5,6,7,5,6,7,5,6,7,5,6,7,5,6,7,5,6,7,5,6,7,5,6,7,5,6,7,5,6],
    [5,6,7,5,6,7,5,6,7,5,6,7,5,6,7,5,6,7,5,6,7,5,6,7,5,6,7,5,6,7],
    [6,7,5,6,7,5,6,7,5,6,7,5,6,7,5,6,7,5,6,7,5,6,7,5,6,7,5,6,7,5],
    [7,5,6,7,5,6,7,5,6,7,5,6,7,5,6,7,5,6,7,5,6,7,5,6,7,5,6,7,5,6],
    [5,6,7,5,6,7,5,6,7,5,6,7,5,6,7,5,6,7,5,6,7,5,6,7,5,6,7,5,6,7],
    [6,7,5,6,7,5,6,7,5,6,7,5,6,7,5,6,7,5,6,7,5,6,7,5,6,7,5,6,7,5],
    [7,5,6,7,5,6,7,5,6,7,5,6,7,5,6,7,5,6,7,5,6,7,5,6,7,5,6,7,5,6],
    [5,6,7,5,6,7,5,6,7,5,6,7,5,6,7,5,6,7,5,6,7,5,6,7,5,6,7,5,6,7],
    [6,7,5,6,7,5,6,7,5,6,7,5,6,7,5,6,7,5,6,7,5,6,7,5,6,7,5,6,7,5],
    [7,5,6,7,5,6,7,5,6,7,5,6,7,5,6,7,5,6,7,5,6,7,5,6,7,5,6,7,5,6],
    [5,6,7,5,6,7,5,6,7,5,6,7,5,6,7,5,6,7,5,6,7,5,6,7,5,6,7,5,6,7],
    [6,7,5,6,7,5,6,7,5,6,7,5,6,7,5,6,7,5,6,7,5,6,7,5,6,7,5,6,7,5],
    [7,5,6,7,5,6,7,5,6,7,5,6,7,5,6,7,5,6,7,5,6,7,5,6,7,5,6,7,5,6],
    [5,6,7,5,6,7,5,6,7,5,6,7,5,6,7,5,6,7,5,6,7,5,6,7,5,6,7,5,6,7],
    [6,7,5,6,7,5,6,7,5,6,7,5,6,7,5,6,7,5,6,7,5,6,7,5,6,7,5,6,7,5],
    [7,5,6,7,5,6,7,5,6,7,5,6,7,5,6,7,5,6,7,5,6,7,5,6,7,5,6,7,5,6],
    [5,6,7,5,6,7,5,6,7,5,6,7,5,6,7,5,6,7,5,6,7,5,6,7,5,6,7,5,6,7],
    [6,7,5,6,7,5,6,7,5,6,7,5,6,7,5,6,7,5,6,7,5,6,7,5,6,7,5,6,7,5],
    [7,5,6,7,5,6,7,5,6,7,5,6,7,5,6,7,5,6,7,5,6,7,5,6,7,5,6,7,5,6],
    [5,6,7,5,6,7,5,6,7,5,6,7,5,6,7,5,6,7,5,6,7,5,6,7,5,6,7,5,6,7],
    [6,7,5,6,7,5,6,7,5,6,7,5,6,7,5,6,7,5,6,7,5,6,7,5,6,7,5,6,7,5],
    [7,5,6,7,5,6,7,5,6,7,5,6,7,5,6,7,5,6,7,5,6,7,5,6,7,5,6,7,5,6],
    [5,6,7,5,6,7,5,6,7,5,6,7,5,6,7,5,6,7,5,6,7,5,6,7,5,6,7,5,6,7],
    [6,7,5,6,7,5,6,7,5,6,7,5,6,7,5,6,7,5,6,7,5,6,7,5,6,7,5,6,7,5],
    [7,5,6,7,5,6,7,5,6,7,5,6,7,5,6,7,5,6,7,5,6,7,5,6,7,5,6,7,5,6]
  ]
} 