{
  "matriz": { "filas": 30, "columnas": 30 },
  "origen": [0, 0],
  "destino": [29, 29],
  "agujerosNegros": [
    [5, 5], [5, 6], [6, 5], [6, 6],
    [12, 12], [12, 13], [13, 12], [13, 13],
    [19, 19], [19, 20], [20, 19], [20, 20],
    [26, 26], [26, 27], [27, 26], [27, 27],
    [8, 15], [9, 15], [10, 15],
    [15, 8], [15, 9], [15, 10],
    [22, 15], [23, 15], [24, 15],
    [15, 22], [15, 23], [15, 24]
  ],
  "estrellasGigantes": [
    [4, 5],
    [11, 12],
    [18, 19],
    [25, 26],
    [7, 15],
    [15, 7],
    [21, 15],
    [15, 21]
  ],
  "portales": [
    { "desde": [3, 3], "hasta": [10, 10] },
    { "desde": [10, 11], "hasta": [17, 17] },
    { "desde": [17, 18], "hasta": [24, 24] },
    { "desde": [24, 25], "hasta": [28, 28] }
  ],
  "agujerosGusano": [
    { "entrada": [7, 7], "salida": [14, 14] },
    { "entrada": [14, 15], "salida": [21, 21] },
    { "entrada": [21, 22], "salida": [27, 27] }
  ],
  "zonasRecarga": [
    [2, 2, 2],
    [9, 9, 2],
    [16, 16, 3],
    [23, 23, 2],
    [28, 28, 3]
  ],
  "celdasCargaRequerida": [
    { "coordenada": [5, 5], "cargaGastada": 20 },
    { "coordenada": [12, 12], "cargaGastada": 30 },
    { "coordenada": [19, 19], "cargaGastada": 40 },
    { "coordenada": [26, 26], "cargaGastada": 50 },
    { "coordenada": [15, 15], "cargaGastada": 35 },
    { "coordenada": [28, 28], "cargaGastada": 45 }
  ],
  "cargaInicial": 50,
  "matrizInicial": [
    [3,4,2,3,4,2,3,4,2,3,4,2,3,4,2,3,4,2,3,4,2,3,4,2,3,4,2,3,4,2],
    [2,3,4,2,3,4,2,3,4,2,3,4,2,3,4,2,3,4,2,3,4,2,3,4,2,3,4,2,3,4],
    [4,2,3,4,2,3,4,2,3,4,2,3,4,2,3,4,2,3,4,2,3,4,2,3,4,2,3,4,2,3],
    [3,4,2,3,4,2,3,4,2,3,4,2,3,4,2,3,4,2,3,4,2,3,4,2,3,4,2,3,4,2],
    [2,3,4,2,3,4,2,3,4,2,3,4,2,3,4,2,3,4,2,3,4,2,3,4,2,3,4,2,3,4],
    [4,2,3,4,2,3,4,2,3,4,2,3,4,2,3,4,2,3,4,2,3,4,2,3,4,2,3,4,2,3],
    [3,4,2,3,4,2,3,4,2,3,4,2,3,4,2,3,4,2,3,4,2,3,4,2,3,4,2,3,4,2],
    [2,3,4,2,3,4,2,3,4,2,3,4,2,3,4,2,3,4,2,3,4,2,3,4,2,3,4,2,3,4],
    [4,2,3,4,2,3,4,2,3,4,2,3,4,2,3,4,2,3,4,2,3,4,2,3,4,2,3,4,2,3],
    [3,4,2,3,4,2,3,4,2,3,4,2,3,4,2,3,4,2,3,4,2,3,4,2,3,4,2,3,4,2],
    [2,3,4,2,3,4,2,3,4,2,3,4,2,3,4,2,3,4,2,3,4,2,3,4,2,3,4,2,3,4],
    [4,2,3,4,2,3,4,2,3,4,2,3,4,2,3,4,2,3,4,2,3,4,2,3,4,2,3,4,2,3],
    [3,4,2,3,4,2,3,4,2,3,4,2,3,4,2,3,4,2,3,4,2,3,4,2,3,4,2,3,4,2],
    [2,3,4,2,3,4,2,3,4,2,3,4,2,3,4,2,3,4,2,3,4,2,3,4,2,3,4,2,3,4],
    [4,2,3,4,2,3,4,2,3,4,2,3,4,2,3,4,2,3,4,2,3,4,2,3,4,2,3,4,2,3],
    [3,4,2,3,4,2,3,4,2,3,4,2,3,4,2,3,4,2,3,4,2,3,4,2,3,4,2,3,4,2],
    [2,3,4,2,3,4,2,3,4,2,3,4,2,3,4,2,3,4,2,3,4,2,3,4,2,3,4,2,3,4],
    [4,2,3,4,2,3,4,2,3,4,2,3,4,2,3,4,2,3,4,2,3,4,2,3,4,2,3,4,2,3],
    [3,4,2,3,4,2,3,4,2,3,4,2,3,4,2,3,4,2,3,4,2,3,4,2,3,4,2,3,4,2],
    [2,3,4,2,3,4,2,3,4,2,3,4,2,3,4,2,3,4,2,3,4,2,3,4,2,3,4,2,3,4],
    [4,2,3,4,2,3,4,2,3,4,2,3,4,2,3,4,2,3,4,2,3,4,2,3,4,2,3,4,2,3],
    [3,4,2,3,4,2,3,4,2,3,4,2,3,4,2,3,4,2,3,4,2,3,4,2,3,4,2,3,4,2],
    [2,3,4,2,3,4,2,3,4,2,3,4,2,3,4,2,3,4,2,3,4,2,3,4,2,3,4,2,3,4],
    [4,2,3,4,2,3,4,2,3,4,2,3,4,2,3,4,2,3,4,2,3,4,2,3,4,2,3,4,2,3],
    [3,4,2,3,4,2,3,4,2,3,4,2,3,4,2,3,4,2,3,4,2,3,4,2,3,4,2,3,4,2],
    [2,3,4,2,3,4,2,3,4,2,3,4,2,3,4,2,3,4,2,3,4,2,3,4,2,3,4,2,3,4],
    [4,2,3,4,2,3,4,2,3,4,2,3,4,2,3,4,2,3,4,2,3,4,2,3,4,2,3,4,2,3],
    [3,4,2,3,4,2,3,4,2,3,4,2,3,4,2,3,4,2,3,4,2,3,4,2,3,4,2,3,4,2],
    [2,3,4,2,3,4,2,3,4,2,3,4,2,3,4,2,3,4,2,3,4,2,3,4,2,3,4,2,3,4],
    [4,2,3,4,2,3,4,2,3,4,2,3,4,2,3,4,2,3,4,2,3,4,2,3,4,2,3,4,2,3]
  ]
} 